-3
10
-3
4
00000000000000
00000111111100
00000111111100
01000111111100
00000111111100
10000111111100
00000111111100
00000111111100
